ABS	ABSOLUTE
APPL-ALERT	APPL-ALERT-BOXES
AUTO-COMP	AUTO-COMPLETION
AUTO-IND	AUTO-INDENT
AUTO-Z	AUTO-ZAP
AVE	AVERAGE
BACKWARD	BACKWARDS
BATCH	BATCH-MODE
BGC	BGCOLOR
BORDER-B	BORDER-BOTTOM-CHARS
BORDER-BOTTOM-P	BORDER-BOTTOM-PIXELS
BORDER-L	BORDER-LEFT-CHARS
BORDER-LEFT-P	BORDER-LEFT-PIXELS
BORDER-R	BORDER-RIGHT-CHARS
BORDER-RIGHT-P	BORDER-RIGHT-PIXELS
BORDER-T	BORDER-TOP-CHARS
BORDER-TOP-P	BORDER-TOP-PIXELS
BOX-SELECT	BOX-SELECTABLE
BUTTON	BUTTONS
CHAR	CHARACTER
CLEAR-SELECT	CLEAR-SELECTION
CLEAR-SORT-ARROW	CLEAR-SORT-ARROWS
COLON-ALIGN	COLON-ALIGNED
COL	COLUMN
CONVERT-TO-OFFS	CONVERT-TO-OFFSET
CURRENT-ENV	CURRENT-ENVIRONMENT
DATA-ENTRY-RET	DATA-ENTRY-RETURN
DATA-T	DATA-TYPE
DATE-F	DATE-FORMAT
DDE-I	DDE-ID
DEBU	DEBUG
DEC	DECIMAL
DEFAUT-B	DEFAULT-BUTTON
DEFAULT-EX	DEFAULT-EXTENSION
DISPLAY-T	DISPLAY-TYPE
EDGE	EDGE-CHARS
EDGE-P	EDGE-PIXELS
ERROR-COL	ERROR-COLUMN
EVENT-T	EVENT-TYPE
FGC	FGCOLOR
FILE-OFF	FILE-OFFSET
FIRST-PROC	FIRST-PROCEDURE
FIRST-TAB-I	FIRST-TAB-ITEM
FORE	FOREGROUND
FORMATTE	FORMATTED
FORWARD	FORWARDS
FRAGMEN	FRAGMENT
FRAME-SPA	FRAME-SPACING
FROM-CUR	FROM-CURRENT
FULL-HEIGHT	FULL-HEIGHT-CHARS
FULL-HEIGHT-P	FULL-HEIGHT-PIXELS
FULL-PATHN	FULL-PATHNAME
FULL-WIDTH	FULL-WIDTH-CHARS
FULL-WIDTH-P	FULL-WIDTH-PIXELS
GET-BLUE	GET-BLUE-VALUE
GET-GREEN	GET-GREEN-VALUE
GET-RED	GET-RED-VALUE
GET-SELECTED	GET-SELECTED-WIDGET
GET-TEXT-HEIGHT	GET-TEXT-HEIGHT-CHARS
GET-TEXT-HEIGHT-P	GET-TEXT-HEIGHT-PIXELS
GET-TEXT-WIDTH	GET-TEXT-WIDTH-CHARS
GET-TEXT-WIDTH-P	GET-TEXT-WIDTH-PIXELS
GRID-FACTOR-H	GRID-FACTOR-HORIZONTAL
GRID-FACTOR-V	GRID-FACTOR-VERTICAL
GRID-UNIT-HEIGHT	GRID-UNIT-HEIGHT-CHARS
GRID-UNIT-HEIGHT-P	GRID-UNIT-HEIGHT-PIXELS
GRID-UNIT-WIDTH	GRID-UNIT-WIDTH-CHARS
GRID-UNIT-WIDTH-P	GRID-UNIT-WIDTH-PIXELS
HEIGHT	HEIGHT-CHARS
HEIGHT-P	HEIGHT-PIXELS
HORI	HORIZONTAL
IMAGE-SIZE-C	IMAGE-SIZE-CHARS
IMAGE-SIZE-P	IMAGE-SIZE-PIXELS
INFO	INFORMATION
INHERIT-BGC	INHERIT-BGCOLOR
INHERIT-FGC	INHERIT-FGCOLOR
INIT	INITIAL
INSERT-B	INSERT-BACKTAB
INSERT-T	INSERT-TAB
INT	INTEGER
IS-CLAS	IS-CLASS
KEEP-FRAME-Z	KEEP-FRAME-Z-ORDER
LABEL-BGC	LABEL-BGCOLOR
LABEL-DC	LABEL-DCOLOR
LABEL-FGC	LABEL-FGCOLOR
LABEL-PFC	LABEL-PFCOLOR
LANGUAGE	LANGUAGES
LAST-PROCE	LAST-PROCEDURE
LAST-TAB-I	LAST-TAB-ITEM
LEFT-ALIGN	LEFT-ALIGNED
LOAD-MOUSE-P	LOAD-MOUSE-POINTER
MARGIN-HEIGHT	MARGIN-HEIGHT-CHARS
MARGIN-HEIGHT-P	MARGIN-HEIGHT-PIXELS
MARGIN-WIDTH	MARGIN-WIDTH-CHARS
MARGIN-WIDTH-P	MARGIN-WIDTH-PIXELS
MAX-HEIGHT-C	MAX-HEIGHT-CHARS
MAX-HEIGHT-P	MAX-HEIGHT-PIXELS
MAX	MAXIMUM
MAX-VAL	MAX-VALUE
MAX-WIDTH	MAX-WIDTH-CHARS
MAX-WIDTH-P	MAX-WIDTH-PIXELS
MENU-K	MENU-KEY
MENU-M	MENU-MOUSE
MIN-COLUMN-WIDTH-C	MIN-COLUMN-WIDTH-CHARS
MIN-COLUMN-WIDTH-P	MIN-COLUMN-WIDTH-PIXELS
MIN-HEIGHT	MIN-HEIGHT-CHARS
MIN-HEIGHT-P	MIN-HEIGHT-PIXELS
MIN	MINIMUM
MIN-VAL	MIN-VALUE
MIN-WIDTH	MIN-WIDTH-CHARS
MIN-WIDTH-P	MIN-WIDTH-PIXELS
MOD	MODULO
MOUSE-P	MOUSE-POINTER
MOVE-AFTER	MOVE-AFTER-TAB-ITEM
MOVE-BEFOR	MOVE-BEFORE-TAB-ITEM
MOVE-COL	MOVE-COLUMN
MOVE-TO-B	MOVE-TO-BOTTOM
MOVE-TO-T	MOVE-TO-TOP
NEXT-TAB-I	NEXT-TAB-ITEM
NO-INHERIT-BGC	NO-INHERIT-BGCOLOR
NO-INHERIT-FGC	NO-INHERIT-FGCOLOR
NO-UND	NO-UNDERLINE
NUM-BUT	NUM-BUTTONS
NUM-COL	NUM-COLUMNS
NUMERIC-F	NUMERIC-FORMAT
NUM-LOCKED-COL	NUM-LOCKED-COLUMNS
NUM-SELECTED	NUM-SELECTED-WIDGETS
ON-FRAME	ON-FRAME-BORDER
OS-DRIVE	OS-DRIVES
PAGE-WID	PAGE-WIDTH
PBE-HASH-ALG	PBE-HASH-ALGORITHM
PFC	PFCOLOR
PIXELS-PER-COL	PIXELS-PER-COLUMN
POPUP-M	POPUP-MENU
POPUP-O	POPUP-ONLY
PRESEL	PRESELECT
PREV-TAB-I	PREV-TAB-ITEM
PRIVATE-D	PRIVATE-DATA
PROCE	PROCEDURE
PROGRESS-S	PROGRESS-SOURCE
RESIZA	RESIZABLE
RETURN-INS	RETURN-INSERTED
RETURN-TO-START-DI	RETURN-TO-START-DIR
RETURN-VAL	RETURN-VALUE
RETURN-ALIGN	RIGHT-ALIGNED
HEIGHT	ROW-HEIGHT-CHARS
HEIGHT-P	ROW-HEIGHT-PIXELS
SCREEN-VAL	SCREEN-VALUE
SCROLLBAR-H	SCROLLBAR-HORIZONTAL
SCROLLBAR-V	SCROLLBAR-VERTICAL
SCROLLED-ROW-POS	SCROLLED-ROW-POSITION
SCROLL-TO-I	SCROLL-TO-ITEM
send-sql	send-sql-statement
SET-BLUE	SET-BLUE-VALUE
SET-GREEN	SET-GREEN-VALUE
SET-RED	SET-RED-VALUE
SIDE-LABEL-H	SIDE-LABEL-HANDLE
SIDE-LAB	SIDE-LABELS
SIZE-C	SIZE-CHARS
SIZE-P	SIZE-PIXELS
STOPPE	STOPPED
STORED-PROC	STORED-PROCEDURE
SUB-AVE	SUB-AVERAGE
SUM-MAX	SUB-MAXIMUM
SUB-	SUB-MENU
SUB-MIN	SUB-MINIMUM
SUBST	SUBSTITUTE
SUBSTR	SUBSTRING
SUPPRESS-W	SUPPRESS-WARNINGS
SYSTEM-ALERT	SYSTEM-ALERT-BOXES
TEMP-DIR	TEMP-DIRECTORY
TITLE-BGC	TITLE-BGCOLOR
TITLE-DC	TITLE-DCOLOR
TITLE-FGC	TITLE-FGCOLOR
TITLE-FO	TITLE-FONT
TRUNC	TRUNCATE
UNBUFF	UNBUFFERED
VAR	VARIABLE
VERT	VERTICAL
VIRTUAL-HEIGHT	VIRTUAL-HEIGHT-CHARS
VIRTUAL-HEIGHT-P	VIRTUAL-HEIGHT-PIXELS
VIRTUAL-WIDTH	VIRTUAL-WIDTH-CHARS
VIRTUAL-WIDTH-P	VIRTUAL-WIDTH-PIXELS
WIDGET-E	WIDGET-ENTER
WIDGET-L	WIDGET-LEAVE
WIDTH	WIDTH-CHARS
WIDTH-P	WIDTH-PIXELS
WINDOW-STA	WINDOW-STATE
&GLOB	&GLOBAL-DEFINE
&SCOP	&SCOPED-DEFINE
&UNDEF	&UNDEFINE
ACCUM	ACCUMULATE
AMBIG	AMBIGUOUS
ANALYZ	ANALYZE
ASC	ASCENDING
ATTR	ATTR-SPACE
AUTO-RET	AUTO-RETURN
AVAIL	AVAILABLE
BACK	BACKGROUND
BEFORE-H	BEFORE-HIDE
CASE-SEN	CASE-SENSITIVE
CENTER	CENTERED
COLUMN-LAB	COLUMN-LABEL
CURRENT-LANG	CURRENT-LANGUAGE
CURS	CURSOR
DATA-REL	DATA-RELATION
DBREST	DBRESTRICTIONS
DBVERS	DBVERSION
DEFAULT-NOXL	DEFAULT-NOXLATE
DEF	DEFINE
DEL	DELETE
DESC	DESCENDING
DICT	DICTIONARY
DISCON	DISCONNECT
DISP	DISPLAY
ERROR-STAT	ERROR-STATUS
EXCLUSIVE	EXCLUSIVE-LOCK
FIELD	FIELDS
FILE-INFO	FILE-INFORMATION
FORM	FORMAT
FRAM	FRAME
FRAME-INDE	FRAME-INDEX
FRAME-VAL	FRAME-VALUE
FROM-C	FROM-CHARS
FROM-P	FROM-PIXELS
GATEWAY	GATEWAYS
GET-FILE-OFFSE	GET-FILE-OFFSET
GET-KEY-VAL	GET-KEY-VALUE
GO-PEND	GO-PENDING
GRAPHIC-E	GRAPHIC-EDGE
INPUT-O	INPUT-OUTPUT
IS-ATTR	IS-ATTR-SPACE
IS-ATTR	IS-LEAD-BYTE
KEYFUNC	KEYFUNCTION
KEY-FUNC	KEY-FUNCTION
LAST-EVEN	LAST-EVENT
LINE-COUNT	LINE-COUNTER
LISTI	LISTING
NO-ATTR	NO-ATTR-LIST
NO-ATTR	NO-ATTR-SPACE
NO-F	NO-FILL
NO-LABEL	NO-LABELS
NO-MES	NO-MESSAGE
NO-PREFE	NO-PREFETCH
NO-VAL	NO-VALIDATE
NUM-ALI	NUM-ALIASES
PAGE-BOT	PAGE-BOTTOM
PAGE-NUM	PAGE-NUMBER
PARAM	PARAMETER
PERSIST	PERSISTENT
PREPROC	PREPROCESS
PROC-HA	PROC-HANDLE
PROC-ST	PROC-STATUS
PROMPT-F	PROMPT-FOR
PROVERS	PROVERSION
PUT-KEY-VAL	PUT-KEY-VALUE
RCODE-INFO	RCODE-INFORMATION
RECT	RECTANGLE
SAX-COMPLE	SAX-COMPLETE
SETUSER	SETUSERID
SHARE	SHARE-LOCK
SHOW-STAT	SHOW-STATS
TERM	TERMINAL
UNDERL	UNDERLINE
UNFORM	UNFORMATTED
WINDOW-MAXIM	WINDOW-MAXIMIZED
WINDOW-MINIM	WINDOW-MINIMIZED
WORK-TAB	WORK-TABLE